EEEEEEEEEEEEEEEEEEEE
E__________________E
E__________________E
E__S___________S___E
E__________________E
E__________________E
E__________________E
E__________________E
E__________________E
E________S_SSSS____E
E________S_S_______E
E________S_S_______E
E_______SSSS_______E
E________S_________E
E__________________E
E__S___________S___E
E__________________E
E__________________E
E__________________E
EEEEEEEEEEEEEEEEEEEE