EEEEEEEEEEEEEEEEEEEE
E__________________E
E__________________E
E__S___________S___E
E__________________E
E__________________E
E___BBBBBBBBBBBB___E
E__________________E
E__________________E
E__________________E
E__________________E
E__________________E
E_______SSS________E
E__________________E
E__________________E
E__S___________S___E
E__________________E
E__________________E
E__________________E
EEEEEEEEEEEEEEEEEEEE